"filename", "language", "TOML", "Rust", "comment", "blank", "total"
"/home/mao/biye/code-management-backend/Cargo.lock", "TOML", 2229, 0, 2, 258, 2489
"/home/mao/biye/code-management-backend/Cargo.toml", "TOML", 26, 0, 0, 2, 28
"/home/mao/biye/code-management-backend/config.toml", "TOML", 6, 0, 0, 3, 9
"/home/mao/biye/code-management-backend/src/dtos/mod.rs", "Rust", 0, 1, 0, 1, 2
"/home/mao/biye/code-management-backend/src/dtos/request.rs", "Rust", 0, 62, 0, 17, 79
"/home/mao/biye/code-management-backend/src/gitmodule/mod.rs", "Rust", 0, 773, 0, 124, 897
"/home/mao/biye/code-management-backend/src/gitmodule/structs.rs", "Rust", 0, 106, 0, 16, 122
"/home/mao/biye/code-management-backend/src/handlers/handler.rs", "Rust", 0, 304, 0, 52, 356
"/home/mao/biye/code-management-backend/src/handlers/mod.rs", "Rust", 0, 1, 0, 1, 2
"/home/mao/biye/code-management-backend/src/lib.rs", "Rust", 0, 72, 0, 4, 76
"/home/mao/biye/code-management-backend/src/main.rs", "Rust", 0, 56, 0, 5, 61
"/home/mao/biye/code-management-backend/src/models/mod.rs", "Rust", 0, 1, 0, 1, 2
"/home/mao/biye/code-management-backend/src/models/user.rs", "Rust", 0, 23, 0, 2, 25
"/home/mao/biye/code-management-backend/src/routes/auth.rs", "Rust", 0, 1, 0, 1, 2
"/home/mao/biye/code-management-backend/src/routes/mod.rs", "Rust", 0, 1, 0, 1, 2
"/home/mao/biye/code-management-backend/src/services/mod.rs", "Rust", 0, 1, 0, 1, 2
"/home/mao/biye/code-management-backend/src/services/service.rs", "Rust", 0, 263, 0, 46, 309
"/home/mao/biye/code-management-backend/src/shared/auth_middleware.rs", "Rust", 0, 46, 0, 4, 50
"/home/mao/biye/code-management-backend/src/shared/error.rs", "Rust", 0, 28, 0, 3, 31
"/home/mao/biye/code-management-backend/src/shared/jwt.rs", "Rust", 0, 60, 0, 9, 69
"/home/mao/biye/code-management-backend/src/shared/mod.rs", "Rust", 0, 5, 0, 1, 6
"/home/mao/biye/code-management-backend/src/shared/response.rs", "Rust", 0, 48, 0, 5, 53
"/home/mao/biye/code-management-backend/src/shared/setting.rs", "Rust", 0, 39, 0, 6, 45
"/home/mao/biye/code-management-backend/src/vos/mod.rs", "Rust", 0, 9, 0, 2, 11
"/home/mao/biye/code-management-backend/src/vos/userdata.rs", "Rust", 0, 7, 0, 1, 8
"Total", "-", 2261, 1907, 2, 566, 4736